Eine	Eine
Schachtel	Schachtel
wird	wird
Ihr	Ihr
mit	mit
dem	dem
Poſtwagen	Postwagen
zukommen	zukommen
,	,
beſte	beste
Frau	Frau
Mutter	Mutter
,	,
darin	darin
ſich	sich
eine	eine
Taſſe	Tasse
befindet	befindet
;	;
es	es
iſt	ist
das	das
ſehnlichſte	sehnlichste
Verlangen	Verlangen
Sie	Sie
wieder	wieder
zu	zu
ſehen	sehen
,	,
was	was
mich	mich
treibt	treibt
Ihr	Ihr
ſolche	solche
unwürdige	unwürdige
Zeichen	Zeichen
meiner	meiner
Verehrung	Verehrung
zu	zu
ſenden	senden
.	.
