ALs	Als	als	KOUS
die	die	d	ART
Bruͤder	Brüder	Bruder	NN
Josephs	Josephs	Joseph	NE
seinen	seinen	sein	PPOSAT
/	/	/	$(
in	in	in	APPR
Bocks	Bocks	Bock	NN
Bluth	Blut	Blut	NN
getuncketen	getunkten	getunkt	ADJA
Rock	Rock	Rock	NN
ihrem	ihrem	ihr	PPOSAT
Vater	Vater	Vater	NN
/	/	/	$(
der	der	d	PRELS
den	den	d	ART
Joseph	Joseph	Joseph	NE
lieber	lieber	gern	ADJD
hatte	hatte	haben	VAFIN
/	/	/	$(
als	als	als	KOKOM
alle	alle	all	PIAT
seine	seine	sein	PPOSAT
Kinder	Kinder	Kind	NN
/	/	/	$(
zuschicketen	zuschickten	zuschicken	VVFIN
/	/	/	$(
und	und	und	KON
ihm	ihm	er	PPER
dabey	dabei	dabei	PAV
sagen	sagen	sagen	VVINF
liessen	ließen	lassen	VVFIN
/	/	/	$(
Diesen	Diesen	dies	PDS
haben	haben	haben	VAFIN
wir	wir	wir	PPER
funden	gefunden	finden	VVPP
/	/	/	$(
siehe	siehe	sehen	VVIMP
ob	ob	ob	KOUS
es	es	es	PPER
deines	deines	dein	PPOSAT
Sohns	Sohns	Sohn	NN
Rock	Rock	Rock	NN
sey	sei	sein	VAFIN
/	/	/	$(
oder	oder	oder	KON
nicht	nicht	nicht	PTKNEG
/	/	/	$(
sprach	sprach	sprechen	VVFIN
Jacob	Jacob	Jacob	NE
;	;	;	$.
Ein	ein	ein	ART
boͤses	böses	böse	ADJA
Thier	Tier	Tier	NN
hat	hat	haben	VAFIN
ihn	ihn	er	PPER
gefressen	gefressen	fressen	VVPP
/	/	/	$(
ein	ein	ein	ART
reissend	reißendes	reißend	ADJA
Thier	Tier	Tier	NN
hat	hat	haben	VAFIN
Joseph	Joseph	Joseph	NE
zerrissen	zerrissen	zerreißen	VVPP
.	.	.	$.
Und	Und	und	KON
Jacob	Jacob	Jacob	NE
zureis	zerriß	zerreißen	VVFIN
seine	seine	sein	PPOSAT
Kleider	Kleider	Kleid	NN
/	/	/	$(
und	und	und	KON
legete	legte	legen	VVFIN
einen	einen	ein	ART
Sack	Sack	Sack	NN
umb	um	um	APPR
seine	seine	sein	PPOSAT
Lenden	Lenden	Lende	NN
/	/	/	$(
und	und	und	KON
trug	trug	tragen	VVFIN
Leid	Leid	Leid	NN
umb	um	um	APPR
seinen	seinen	sein	PPOSAT
Sohn	Sohn	Sohn	NN
lange	lange	lang	ADJA
Zeit	Zeit	Zeit	NN
.	.	.	$.
